
KHR = "countries/Kharan.txt"
LBE = "countries/Las Bela.txt"
RJK = "countries/Rajkot.txt"
VIJ = "countries/Vijayanagar.txt"
DNT = "countries/Danta.txt"
BNP = "countries/Banganapelle.txt"
SDR = "countries/Sandur.txt"
SVN = "countries/Savanur.txt"
SVV = "countries/Savantvadi.txt"
SGT = "countries/Sangli.txt"
MDH = "countries/Mudhol.txt"
JMK = "countries/Jamkhandi.txt"
JTH = "countries/Jath.txt"
AUN = "countries/Aundh.txt"
KUN = "countries/Kurunwad.txt"
AKT = "countries/Akalkot.txt"
BRR = "countries/Bhor.txt"
PHT = "countries/Phaltah.txt"
GNL = "countries/Gondal.txt"
JWH = "countries/Jawhar.txt"
DRP = "countries/Dharampur.txt"
BND = "countries/Bansda.txt"
SRG = "countries/Surgana.txt"
MOV = "countries/Morvi.txt"
WKR = "countries/Wankaner.txt"
DRL = "countries/Dhrol.txt"
CBY = "countries/Cambay.txt"
THD = "countries/Tharad.txt"
RHP = "countries/Radhanpur.txt"
KSS = "countries/Khasi.txt"
KTW = "countries/Katarawadi.txt"
BWL = "countries/Bawlake.txt"
KYY = "countries/Kyebogyi.txt"
NMM = "countries/Nammekon.txt"
BLS = "countries/Balasinor.txt"
LNV = "countries/Lunavada.txt"
SNT = "countries/Sant.txt"
BRY = "countries/Bariya.txt"
KHH = "countries/Kushalgarh.txt"
JHB = "countries/Jhabua.txt"
SJM = "countries/Sanjeda Mehvassi.txt"
CUD = "countries/Chota Udaipur.txt"
ALR = "countries/Ali Rajpur.txt"
BWR = "countries/Barwani.txt"
MKR = "countries/Makrai.txt"
NRG = "countries/Narsingarh.txt"
KLC = "countries/Kilchipur.txt"
AMB = "countries/Amb.txt"
DIR = "countries/Dir.txt"
SWT = "countries/Swat.txt"
MKN = "countries/Makran.txt"
NAG = "countries/Nagar.txt"
HZA = "countries/Hunza.txt"
CHM = "countries/Chamba.txt"
BSP = "countries/Bilaspur.txt"
MHD = "countries/Mahdi.txt"
SUT = "countries/Suket.txt"
SRM = "countries/Sirmur.txt"
TGW = "countries/Tehrigawhal.txt"
PNP = "countries/Panipat.txt"
MKO = "countries/Maler Kotla.txt"
FRK = "countries/Faridkot.txt"
DJN = "countries/Dujana.txt"
GNW = "countries/Gandhwani.txt"
PTD = "countries/Pataudi.txt"
KHD = "countries/Khaniadhana.txt"
SMT = "countries/Samthar.txt"
CKH = "countries/Charkhari.txt"
BRI = "countries/Beri.txt"
BAO = "countries/Baoni.txt"
PNA = "countries/Panna.txt"
CHH = "countries/Chhatarpur.txt"
MHR = "countries/Maihar.txt"
BIJ = "countries/Bijawar.txt"
AJG = "countries/Ajaigarh.txt"
JSO = "countries/Jaso.txt"
UHH = "countries/Unchahra.txt"
KOI = "countries/Kothi.txt"
BUN = "countries/Baraunda.txt"
PLD = "countries/Paldeo.txt"
BTR = "countries/Bastar.txt"
KNK = "countries/Kanker.txt"
KAH = "countries/Kalahandi.txt"
PAA = "countries/Patna.txt"
CGG = "countries/Changbhakar.txt"
KRA = "countries/KoreaInd.txt"
SGJ = "countries/Surguja.txt"
JSP = "countries/Jashpur.txt"
SKI = "countries/Sakti.txt"
RGH = "countries/Raigarh.txt"
SGH = "countries/Sarangarh.txt"
GGP = "countries/Gangpur.txt"
NGN = "countries/Nandgaon.txt"
KGH = "countries/Khairagarh.txt"
CKD = "countries/Chhuikadan.txt"
KDH = "countries/Kawardha.txt"
SNP = "countries/Sonpur.txt"
BDH = "countries/Baudh.txt"
KHM = "countries/Khondmals.txt"
DLL = "countries/Daspalla.txt"
NYG = "countries/Nayagarh.txt"
RAP = "countries/Ranpur.txt"
ATK = "countries/Athmallik.txt"
RKL = "countries/Rairakhol.txt"
BMM = "countries/Bamra.txt"
BNJ = "countries/Bonaj.txt"
DHK = "countries/Dhenkanal.txt"
TLC = "countries/Talcher.txt"
PLH = "countries/Pal Lahara.txt"
KJH = "countries/Keonjhar.txt"
NLG = "countries/Nilgiri.txt"
MBJ = "countries/Magurbhanj.txt"
SKL = "countries/Saraikela.txt"
KSW = "countries/Kharsawan.txt"
OMN = "countries/OmanNew.txt"
UP2 = "countries/Udaipur.txt"
JGN = "countries/Jigni.txt"
LHR = "countries/Loharu.txt"
RJG = "countries/Rajgarh.txt"
NNP = "countries/Naungpale.txt"
WDN = "countries/West Aden.txt"
EDN = "countries/East Aden.txt"
ADE = "countries/Aden City.txt"
LHJ = "countries/Lahej.txt"
AQR = "countries/Aqrabi.txt"
AWI = "countries/Alawi.txt"
HSH = "countries/Haushabi.txt"
MFL = "countries/Muflihi.txt"
SHB = "countries/Shaib.txt"
UYF = "countries/Upper Yafa.txt"
LYF = "countries/Lower Yafa.txt"
FDH = "countries/Fadhli.txt"
ADH = "countries/Dhala.txt"
LAQ = "countries/Lower Aulaqi.txt"
ASL = "countries/Upper Aulaqi Sultanate.txt"
ASH = "countries/Upper Aulaqi Sheikhdom.txt"
BHN = "countries/Beihan.txt"
DTH = "countries/Dathina.txt"
AHL = "countries/Audhali.txt"
QTI = "countries/Quaiti.txt"
KTR = "countries/Kathiri.txt"
MHA = "countries/Mahra.txt"
WBL = "countries/Wahidi Balhaf.txt"
WBH = "countries/Wahidi Haban.txt"
WBA = "countries/Wahidi Bir Ali.txt"
AWH = "countries/Hawra.txt"
AIQ = "countries/Irqa.txt"
FND = "countries/French India.txt"
JJA = "countries/Janjira.txt"
JAF = "countries/Jafrabad.txt"
CHB = "countries/Cooch Behar.txt"
DGH = "countries/Dhrangadhra.txt"
JRA = "countries/Jaora.txt"
JHL = "countries/Jhalawar.txt"
PLP = "countries/Palanpur.txt"
PBD = "countries/Porbandar.txt"
RPL = "countries/Raajpipla.txt"
TPA = "countries/Tripura.txt"
MNP = "countries/Manipur.txt"
CTL = "countries/Chitral.txt"
HYD = "countries/Hyderabad.txt"
MYS = "countries/Mysore.txt"
TVC = "countries/Travancore.txt"
COC = "countries/Cochin.txt"
PUD = "countries/Pudukkottai.txt"
BDA = "countries/Baroda.txt"
JGH = "countries/Junagadh.txt"
NVN = "countries/Nawanagar.txt"
KUT = "countries/Cutch.txt"
BHV = "countries/Bhavnagar.txt"
IDR = "countries/Idar.txt"
ORC = "countries/Orchha.txt"
REW = "countries/Rewa.txt"
BNR = "countries/Benares.txt"
RMP = "countries/Rampur.txt"
RLM = "countries/Ratlam.txt"
BHO = "countries/Bhopal.txt"
INR = "countries/Indore.txt"
GWA = "countries/Gwalior.txt"
DWS = "countries/Dewas Senior.txt"
DWJ = "countries/Dewas Junior.txt"
DHA = "countries/Dhar.txt"
PRG = "countries/Partab Garh.txt"
BNS = "countries/Banswara.txt"
DGP = "countries/Dungarpur.txt"
JIP = "countries/Jaipur.txt"
AWR = "countries/Alwar.txt"
KUL = "countries/Karauli.txt"
BHP = "countries/Bharatpur.txt"
DLP = "countries/Dholpur.txt"
BDI = "countries/Bundi.txt"
KOT = "countries/Kotah.txt"
KHG = "countries/Kishangarh.txt"
UDP = "countries/Udaipur.txt"
TNK = "countries/Tonk.txt"
SRH = "countries/Sirohi.txt"
JDP = "countries/Jodhpur.txt"
BKN = "countries/Bikaner.txt"
JSM = "countries/Jaisalmer.txt"
BHW = "countries/Bahawalpur.txt"
JND = "countries/Jind.txt"
KPT = "countries/Kapurthala.txt"
PTI = "countries/Patiala.txt"
NBH = "countries/Nabha.txt"
NSE = "countries/North Sentinel Island.txt"
SNV = "countries/Soviet Navy.txt"
DTA = "countries/Datia.txt"
KHP = "countries/Kolhapur.txt"
NUD = "countries/Northumberland.txt"
CMX = "countries/Couto Misto.txt"