##Europe##
CAT = "countries/Catalonia.txt"
CRN = "countries/Cornwall.txt"
KTS = "countries/Kingdom of Two Sicilies.txt"
BAV = "countries/Bavaria.txt"
PRS = "countries/Prussia.txt"
VCT = "countries/Vatican.txt"
RUS = "countries/Russia.txt"
EGL = "countries/England.txt"
KOS = "countries/Kosovo.txt"
MRV = "countries/Moravia.txt"
WUR = "countries/Wurttemburg.txt"
SAR = "countries/Saar.txt"
SAX = "countries/Saxony.txt"
DAN = "countries/Danzig.txt"
FLA = "countries/Flanders.txt"
WLL = "countries/Wallonia.txt"
KAR = "countries/Karelia.txt"
BGN = "countries/Burgundy.txt"
BRT = "countries/Brittany.txt"
RHI = "countries/Rhineland.txt"
VNC = "countries/Venice.txt"
LOM = "countries/Lombardy.txt"
PIE = "countries/Piedmont.txt"
TUS = "countries/Tuscany.txt"
SRD = "countries/Sardinia.txt"
BAD = "countries/Baden.txt"
HAN = "countries/Hanover.txt"
HES = "countries/Hesse.txt"
WSF = "countries/Westfalen.txt"
THU = "countries/Thuringia.txt"
SCH = "countries/Schleswig Holstein.txt"
SIL = "countries/Silesia.txt"
BDB = "countries/Brandenburg.txt"
MCK = "countries/Mecklenburg.txt"
POM = "countries/Pomerania.txt"
ALC = "countries/Alsace.txt"
LOR = "countries/Lorraine.txt"
OLD = "countries/Oldenburg.txt"
NAP = "countries/Naples.txt"
SIC = "countries/Sicily.txt"
GEN = "countries/Genoa.txt"
PRM = "countries/Parma.txt"
MDN = "countries/Modena.txt"
GLC = "countries/Galicia and Lodomeria.txt"
TRV = "countries/Transylvania.txt"
DLM = "countries/Dalmatia.txt"
BNT = "countries/Banat.txt"
VJD = "countries/Vojvodina.txt"
TYR = "countries/Tyrol.txt"
LMK = "countries/Lemko.txt"
SDT = "countries/Sudetenland.txt"
LIV = "countries/Livonia.txt"
COU = "countries/Courland.txt"
CRP = "countries/Carpatho-Ukraine.txt"

##Europe Imported from CU##
BSQ = "countries/Basque.txt"
GAL = "countries/Galicia.txt"
CRE = "countries/Crete.txt"
CSC = "countries/Corsica.txt"
ANL = "countries/Andalusia.txt"
FAR = "countries/Faroe.txt"
ALN = "countries/Aland.txt"

#hand-made
TVL = "countries/Tavolara.txt"
BAR = "countries/Barbados.txt"
BSA = "countries/South Antilles.txt"

##Oceania Imported from CU##
PAC = "countries/Pacific Islands.txt"
SLM = "countries/Solomon.txt"
MIC = "countries/Micronesia.txt"
MAR = "countries/Marshall.txt"
PLU = "countries/Palau.txt"
NAU = "countries/Nauru.txt"
NCL = "countries/New Caledonia.txt"
KIR = "countries/Kiribati.txt"
TAH = "countries/Tahiti.txt"
SAM = "countries/Samoa.txt"

##Africa##
TGR = "countries/Tangier.txt"

##Africa Imported from CU##
#Portuguese
CVD = "countries/Cape Verde.txt"
SAO = "countries/Sao Tome.txt"
#British
SEY = "countries/Seychelles.txt"
SML = "countries/Somalialand.txt"
MRS = "countries/Mauritius.txt"
#French
COM = "countries/Comoros.txt"
#Spanish
RIF = "countries/Rif.txt"
ORA = "countries/Oranje.txt"
##Asia##
ROJ = "countries/South Japan.txt"
PRJ = "countries/North Japan.txt"
DPK = "countries/North Korea.txt"
ROK = "countries/South Korea.txt"
TKI = "countries/Tonkin.txt"
SRW = "countries/Sarawak.txt"
BEI = "countries/Brunei.txt"
BEO = "countries/Borneo.txt"
TUG = "countries/Tunganistan.txt"
XIG = "countries/Xikang.txt"
NIX = "countries/Ningxia Ma Clique.txt"
SHC = "countries/Sichuan Clique.txt"
GND = "countries/Guangdong Clique.txt"                                                              
PIL = "countries/Pailingmiao Council.txt"
SHG = "countries/Shangdong.txt"
EHC = "countries/East Hebei.txt"
SHH = "countries/Shanghai.txt"
HMI = "countries/Hami.txt"

##Asia Imported from CU##
TWN = "countries/Taiwan.txt"
ETM = "countries/East Timor.txt"
KAS = "countries/Kashmir.txt"
##Middle-East##
HTY = "countries/Hatay.txt"
KUR = "countries/Kurdistan.txt"
BHR = "countries/Bahrain.txt"
#hand-made
HJZ = "countries/Hejaz.txt"
JBL = "countries/Jabal Shammar.txt"
ASR = "countries/Asir.txt"
##Imported
ADN = "countries/Aden.txt"
##America##
GRL = "countries/Greenland.txt"
CAL = "countries/California.txt"
TEX = "countries/Texas.txt"
QUE = "countries/Quebec.txt"
NFL = "countries/New Foundland.txt"
LOU = "countries/Louisiana.txt"
VER = "countries/Vermont.txt"
FLO = "countries/Florida.txt"
ORG = "countries/Oregon.txt"
NEG = "countries/New England.txt"
ALA = "countries/Alaska.txt"
NHM = "countries/New Hampshire.txt"
ALT = "countries/Alberta.txt"
SAS = "countries/Saskatchewan.txt"
NUN = "countries/Nunavut.txt"
NVS = "countries/Nova Scotia.txt"
HAW = "countries/Hawaii.txt"
MCH = "countries/Michigan.txt"
UTH = "countries/Utah.txt"
ARZ = "countries/Arizona.txt"
NWY = "countries/New York.txt"
BRC = "countries/British Columbia.txt"
CAS = "countries/Cascadia.txt"

##Russia##
SBR = "countries/Siberia.txt"
ALI = "countries/Altai.txt"
YML = "countries/Yamalia.txt"
MSC = "countries/Moscovy.txt"
VLG = "countries/Vologda.txt"
KZN = "countries/Kazan.txt"
VLD = "countries/Volgograd.txt"
DKU = "countries/Don Kuban.txt"
PTG = "countries/Petrograd.txt"
MRM = "countries/Murmansk.txt"
CRM = "countries/Crimea.txt"
ORN = "countries/Orenburg.txt"
BSH = "countries/Bashkortostan.txt"
URL = "countries/Urals.txt"
KHA = "countries/Khabarovsk.txt"

##Others##
SZK = "countries/Szeklerland.txt"
ELB = "countries/Elba.txt"

##City States##
FRN = "countries/Frankfurt.txt"
BRE = "countries/Bremen.txt"
LUB = "countries/Lubeck.txt"
LIE = "countries/Liechtenstein.txt"
MCO = "countries/Monaco.txt"
ADR = "countries/Andorra.txt"
SMR = "countries/San Marino.txt"
TRS = "countries/Trieste.txt"
HAM = "countries/Hamburg.txt"
BRL = "countries/Berlin.txt"
LCC = "countries/Lucca.txt"

##Imported from UES##

LES = "countries/lesotho.txt"
SSU = "countries/south sudan.txt"
SWZ = "countries/swaziland.txt"
TON = "countries/tonga.txt"
TUV = "countries/tuvalu.txt"
VAN = "countries/vanuatu.txt"
ZAN = "countries/zanzibar.txt"

##Special##
UNC = "countries/Unclaimed.txt"
##France##
NND = "countries/Normandy.txt"
PAS = "countries/Paris.txt"
ORL = "countries/Orleans.txt"
PVC = "countries/Provence.txt"

FEA = "countries/FrenchEquatorialAfrica.txt"
FWA = "countries/FrenchWestAfrica.txt"
NCM = "countries/NorthCameroons.txt"
SCM = "countries/SouthCameroons.txt"
WPP = "countries/WestPapua.txt"
STR = "countries/StraitsSettlements.txt"
SGP = "countries/Singapore.txt"
NBO = "countries/NorthBorneo.txt"
WTO = "countries/WestTogo.txt"
RUU = "countries/RuandaUrundi.txt"
NGU = "countries/NewGuinea.txt"
SKM = "countries/Sikkim.txt"
TSC = "countries/Transcaucasia.txt"

##Imported from Pacific Rework Mod

KED = "countries/Kedah.txt"
KEL = "countries/Kelantan.txt"
TGA = "countries/Terengganu.txt"
JOH = "countries/Johor.txt"
PLS = "countries/Perlis.txt"
HKG = "countries/Hong Kong.txt"
#new stuff
ING = "countries/Ingushetia.txt"
ABK = "countries/Abkhazia.txt"
SOS = "countries/South Ossetia.txt"
NOS = "countries/North Ossetia.txt"
KPK = "countries/Karalpakstan.txt"
TRN = "countries/Transnistria.txt"
NGK = "countries/Nagorno-Karabakh.txt"
CHE = "countries/Chechnya.txt"
DAG = "countries/Dagestan.txt"
KMK = "countries/Kalmykia.txt"
ADY = "countries/Adygea.txt"
ADJ = "countries/Adjara.txt"
NAK = "countries/Nakhchivan.txt"
KRC = "countries/Karachay.txt"
CHR = "countries/Cherkessia.txt"
KBK = "countries/Kabardino-Balkaria.txt"
MNX = "countries/Isle of Man.txt"
NOC = "countries/Northern Cyprus.txt"
WLC = "countries/Wallachia.txt"
FRS = "countries/Frisia.txt"
MST = "countries/Mecklenburg-Strelitz.txt"
SWM = "countries/Saxe-Weimar-Eisenach.txt"
ANH = "countries/Anhalt.txt"
BRU = "countries/Brunswick.txt"
SAL = "countries/Saxe-Altenburg.txt"
SCG = "countries/Saxe-Coburg-Gotha.txt"
SME = "countries/Saxe-Meiningen.txt"
LIP = "countries/Lippe.txt"
RGE = "countries/Reuss-Gera.txt"
RGR = "countries/Reuss-Griez.txt"
SLI = "countries/Schaumburg-Lippe.txt"
SRU = "countries/Schwarzburg-Rudolstadt.txt"
SSO = "countries/Schwarzburg-Sondershausen.txt"
WAP = "countries/Waldeck-Pyrmont.txt"
LIM = "countries/Limburg.txt"
NVI = "countries/North Vietnam.txt" #not implemented yet
MRN = "countries/Moresnet.txt"
DOB = "countries/Dobrogea.txt"
BUK = "countries/Bukovina.txt"
SRP = "countries/Srpska.txt"
SCN = "countries/Scania.txt"
SAP = "countries/Sapmi.txt"
NOV = "countries/Novorossiya.txt"
KSH = "countries/Kashubia.txt"
CNR = "countries/Canary Islands.txt"
AZO = "countries/Azores.txt"
MDR = "countries/Madieras.txt"
REU = "countries/Reunion.txt"
ATR = "countries/Asturias.txt"
BAL = "countries/Baleares.txt"
VAL = "countries/Valencia.txt"
LUS = "countries/Lusatia.txt"
ARA = "countries/Aragon.txt"
ABS = "countries/Lakotah.txt"
BLO = "countries/Balochistan.txt"
CAB = "countries/Cabinda.txt"
RIO = "countries/Riogrande.txt"
RGA = "countries/Rio Grande.txt"
YUC = "countries/Yucatan.txt"
MSQ = "countries/Mosquito Coast.txt"
KON = "countries/East Prussia.txt"
PAT = "countries/Patagonia.txt"
RAG = "countries/Ragusa.txt"
BOH = "countries/Bohemia.txt"
CZC = "countries/Czechia.txt"
HZB = "countries/Herzeg-Bosnia.txt"
GAU = "countries/Gaugauzia.txt"
GRI = "countries/Grisons.txt"
MCU = "countries/Macau.txt"
SON = "countries/Sonora.txt"
PMR = "countries/Pamiristan.txt"
KHZ = "countries/Khuzestan.txt"
RPN = "countries/Rapa Nui.txt"
CHP = "countries/Chiapas.txt"
KHL = "countries/Khalistan.txt"
SND = "countries/Sindhudesh.txt"
HOH = "countries/Hohenzollern.txt"
SMA = "countries/Saxony-Magdeburg.txt"
WPR = "countries/West Prussia.txt"
POS = "countries/Posen.txt"
HEN = "countries/Hesse-Nassau.txt"
HKA = "countries/Hesse-Kassel.txt"
SLA = "countries/Saxe-Lauenburg.txt"
VOR = "countries/Vorarlberg.txt"
CRT = "countries/Carinthia.txt"
STY = "countries/Styria.txt"
SLZ = "countries/Salzburg.txt"
UAS = "countries/Upper Austria.txt"
LAS = "countries/Lower Austria.txt"
VNA = "countries/Vienna.txt"
BRG = "countries/Burgenland.txt"
LEY = "countries/Leyen.txt"
NSU = "countries/Nassau.txt"
IST = "countries/Istria.txt"
HHO = "countries/Hesse-Homburg.txt"
PWP = "countries/Posen-West Prussia.txt"
RHD = "countries/Rhodania.txt"
RYU = "countries/Ryukyu.txt"
EZO = "countries/Hokkaido.txt"
STH = "countries/Saint Helena.txt"
BER = "countries/Bermuda.txt"
GIB = "countries/Gibraltar.txt"
FAL = "countries/Falklands.txt"
DMC = "countries/Dominica.txt"
GDA = "countries/Grenada.txt"
MTQ = "countries/Martinique.txt"
NSM = "countries/North Saint Martin.txt"
SSM = "countries/South Saint Martin.txt"
CYM = "countries/Cayman Islands.txt"
TAC = "countries/Turks-Caicos.txt"
STL = "countries/Saint Lucia.txt"
SKT = "countries/Saint Kitts.txt"
NEV = "countries/Nevis.txt"
AGL = "countries/Anguilla.txt"
ANB = "countries/Antigua-Barbuda.txt"
SVC = "countries/Saint Vincent.txt"
SAB = "countries/Saba.txt"
SEU = "countries/Sint Eustatius.txt"
ARU = "countries/Aruba.txt"
BON = "countries/Bonaire.txt"
EVI = "countries/East Virgin Islands.txt"
WVI = "countries/West Virgin Islands.txt"
MSR = "countries/Montserrat.txt"
SBT = "countries/Saint Barthélemy.txt"
SPM = "countries/Saint Pierre-Miquelon.txt"
ESM = "countries/Eastern Samoa.txt"
GUM = "countries/Guam.txt"
JEB = "countries/Jabal Druze.txt"
ALW = "countries/Alawite.txt"
NNL = "countries/Nosnerland.txt"
SHA = "countries/Shan.txt"
KCH = "countries/Kachinland.txt"
RKH = "countries/Arakan.txt"
ASM = "countries/Assam.txt"
GSY = "countries/Guernsey.txt"
JSY = "countries/Jersey.txt"
BIA = "countries/Biafra.txt"
CHT = "countries/Chattagram.txt"
BNG = "countries/Bangabhumi.txt"
SKH = "countries/Sakhalin.txt"
LZG = "countries/Lezgistan.txt"
KHI = "countries/Khiva.txt"
BKH = "countries/Bukhara.txt"
PEN = "countries/Pennsylvania.txt"
MAS = "countries/Massachusetts.txt"
RHO = "countries/Rhode Island.txt"
CON = "countries/Connecticut.txt"
NJR = "countries/New Jersey.txt"
DEL = "countries/Delaware.txt"
MRY = "countries/Maryland.txt"
VIR = "countries/Virginia.txt"
NCR = "countries/North Carolina.txt"
SCR = "countries/South Carolina.txt"
GRG = "countries/Georgia USA.txt"
HYD = "countries/Hyderabad.txt"
MYS = "countries/Mysore.txt"
TVC = "countries/Travancore.txt"
COC = "countries/Cochin.txt"
PUD = "countries/Pudukkottai.txt"
BDA = "countries/Baroda.txt"
JGH = "countries/Junagadh.txt"
NVN = "countries/Nawanagar.txt"
KUT = "countries/Cutch.txt"
BHV = "countries/Bhavnagar.txt"
IDR = "countries/Idar.txt"
ORC = "countries/Orchha.txt"
REW = "countries/Rewa.txt"
BNR = "countries/Benares.txt"
RMP = "countries/Rampur.txt"
RLM = "countries/Ratlam.txt"
BHO = "countries/Bhopal.txt"
INR = "countries/Indore.txt"
GWA = "countries/Gwalior.txt"
DWS = "countries/Dewas Senior.txt"
DWJ = "countries/Dewas Junior.txt"
DHA = "countries/Dhar.txt"
PRG = "countries/Partab Garh.txt"
BNS = "countries/Banswara.txt"
DGP = "countries/Dungarpur.txt"
JIP = "countries/Jaipur.txt"
AWR = "countries/Alwar.txt"
KUL = "countries/Karauli.txt"
BHP = "countries/Bharatpur.txt"
DLP = "countries/Dholpur.txt"
BDI = "countries/Bundi.txt"
KOT = "countries/Kotah.txt"
KHG = "countries/Kishangarh.txt"
UDP = "countries/Udaipur.txt"
TNK = "countries/Tonk.txt"
SRH = "countries/Sirohi.txt"
JDP = "countries/Jodhpur.txt"
BKN = "countries/Bikaner.txt"
JSM = "countries/Jaisalmer.txt"
BHW = "countries/Bahawalpur.txt"
JND = "countries/Jind.txt"
KPT = "countries/Kapurthala.txt"
PTI = "countries/Patiala.txt"
NBH = "countries/Nabha.txt"
NSE = "countries/North Sentinel Island.txt"
DTA = "countries/Datia.txt"
KHP = "countries/Kolhapur.txt"
NVA = "countries/Nevada.txt"
WSH = "countries/Washington.txt"
IDH = "countries/Idaho.txt"
NMX = "countries/New Mexico.txt"
CLR = "countries/Colorado.txt"
WYO = "countries/Wyoming.txt"
MNA = "countries/Montana.txt"
NDA = "countries/North Dakota.txt"
SDA = "countries/South Dakota.txt"
NEB = "countries/Nebraska.txt"
KAN = "countries/Kansas.txt"
OKH = "countries/Oklahoma.txt"
AKS = "countries/Arkansas.txt"
MSS = "countries/Mississippi.txt"
MSI = "countries/Missouri.txt"
IOW = "countries/Iowa.txt"
MNS = "countries/Minnesota.txt"
WSC = "countries/Wisconsin.txt"
ILL = "countries/Illinois.txt"
INA = "countries/Indiana.txt"
OHI = "countries/Ohio.txt"
KNT = "countries/Kentucky.txt"
TNS = "countries/Tennessee.txt"
ALM = "countries/Alabama.txt"
WVR = "countries/West Virginia.txt"
MNE = "countries/Maine.txt"
ONT = "countries/Ontario.txt"
MNB = "countries/Manitoba.txt"
YUK = "countries/Yukon.txt"
NBK = "countries/New Brunswick.txt"
PEI = "countries/Prince Edward Island.txt"
NWT = "countries/Northwest Territories.txt"
LBD = "countries/Labrador.txt"
CHC = "countries/Chicago.txt"
NYC = "countries/Long Island.txt"
NVJ = "countries/Navajo.txt"
CBI = "countries/Cape Breton Island.txt"
VCI = "countries/Vancouver Island.txt"
HDA = "countries/Haida.txt"
MET = "countries/Metis.txt"
GMA = "countries/German America.txt"
PCZ = "countries/Panama Canal Zone.txt"
WDC = "countries/Washington DC.txt"
ABD = "countries/Abu Dhabi.txt"
AJM = "countries/Ajman.txt"
DUB = "countries/Dubai.txt"
RAK = "countries/Ras Al Khaimah.txt"
SHJ = "countries/Sharjah.txt"
UAQ = "countries/Umm Al Quwain.txt"
FUJ = "countries/Fujairah.txt"
SUP = "countries/Superior.txt"
JAO = "countries/Jewish AO.txt"
SCL = "countries/Lower California.txt"